     x      x
     x      x
     x      x
     x      x
     x      x
     x      x
     x      x
     x      x
     x      x
     x      x
     x      x
     x      x
     x      x
     x      x
     x      x
     x      x
     x      x
     x      x
     x      x
     x      x
     x      x
     x      x
     x      x
     x      x
     x      x
     x      x
     x      x
     x      x
     x      x
     x      x
     x      x
     x      x
     x      x
     x      x
     x      x
     x      x
     x      x
     x      x
     x      x
     x      x
     x      x
     x      x
     x      x
     x      x
     x      x
     x      x
     x      x
     x      x
     x      x
     x      x
     x      x
     x      x
     x      x
     x      x
     x      x
     x      x
     x      x
     x      x
     x      x
     x      x
     x      x
     x      x
     x      x
     x      x
     x      x
     x      x
     x      x
     x      x
     x      x
     x      x
     x      x
     x      x
     x      x
     x      x
     x      x
     x      x
     x      x
     x      x
     x      x
     x      x
     x      x
     x      x
     x      x
     x      x
     x      x
     x      x
     x      x
     x      x
     x      x
     x      x
     x      x
     x      x
     x      x
     x      x
     x      x
     x      x
     x      x
     x      x
     x      x
     x      x
 26009   -347
 28134  -3687
 10829  -6831
 18582  -1080
 18556  -3451
 10625  -5277
  8030  -5335
 28920  -3463
-11490  -4023
  9544  -3956
  9756  -1797
 16882  -4663
 16286  -6115
 22560    298
 23079   5347
 16023   -219
 12861  -4570
 13017   -135
 15581  -5471
 -1034  -4500
 31012   1885
  1163  -2272
 32767   6312
 18552   2182
 15437  -7557
 21346  -1184
 16778  -2503
 19286  -2853
 19195  -2094
  3217  -5978
 13104  -3391
 19028  -6352
  9313  -4604
 11144  -1977
 13741    596
 29750  -1043
  5769   3704
 15433  -5015
 29063  -1416
  5844   3461
-10112  -5287
 16939  -4075
  5299  -2623
 25622  -7058
 32767  -4040
  9586  -4465
 22984  -3709
-12079  -4696
 26494  -6361
 13598   -739
 17471  -5481
 10752  -6273
  6660  -6949
  3292  -8337
  1803  -5095
  3577  -5885
 31672  -1625
   752  -3825
  5478  -9182
 15714  -7954
 12256  -8065
  3212  -3325
  -908  -8190
  2949  -5987
 -7356  -5763
  3709  -5896
 11302   1607
  1686  -5198
  3465    155
 -9792  -6701
 19952  -3459
 31996  -4511
 24207   4512
  4962 -11990
 29184   6468
 26416  -3110
  9731  -8292
 16004   -892
 -3077  -4805
 15237    745
-11212  -5652
 -2179  -5005
  9822  -5846
  6028  -2656
 21310  -3335
  -370 -11336
 19284   1626
  6424  -1570
 14567  -6667
 15784  -7327
 19166    253
 17802  -5551
  2254  -5535
   675  -8939
 11599  -7321
 32767   2877
 17973   1947
 24179  -7422
 23720  -1638
 11341   4280
